6	6	6	6	6	6	6	6	6	6	6	6	6	6	6	6	6	6	6	6	6	6	6	6	6	6	6	6	6	6	6	6	6	6	6	6	6	6	6	6	6	6	6	6	6	6	6	6	6	6	6	6	6	6	6	6	6	6	6	6
6	6	6	6	6	6	6	6	6	6	6	6	6	6	6	6	6	6	6	6	6	6	6	6	6	6	6	6	6	6	6	6	6	6	6	6	6	6	6	6	6	6	6	6	6	6	6	6	6	6	6	6	6	6	6	6	6	6	6	6
6	6	6	6	6	6	1	1	1	1	1	1	1	1	1	1	1	1	1	1	1	6	6	6	6	6	6	6	6	6	6	6	6	6	6	6	6	6	6	6	6	6	6	6	6	6	6	6	6	6	6	6	6	6	6	6	6	6	6	6
6	6	6	6	6	6	1	1	1	1	1	1	1	1	1	1	1	1	1	1	1	6	6	6	6	6	6	6	6	6	6	6	6	6	6	6	6	6	6	6	6	6	6	6	6	6	6	6	6	6	6	6	6	6	6	6	6	6	6	6
6	6	6	6	6	6	1	1	6	6	6	6	6	6	6	6	6	6	6	1	1	6	6	6	6	6	6	6	6	6	6	6	6	6	6	6	6	6	6	1	1	1	1	1	1	1	1	1	1	1	1	1	1	1	1	1	1	1	1	1
6	6	6	6	6	6	1	1	6	6	6	6	6	6	6	6	6	6	6	1	1	6	6	6	6	6	6	6	6	6	6	6	6	6	6	6	6	6	6	1	1	1	1	1	1	1	1	1	1	1	1	1	1	1	1	1	1	1	1	1
6	6	6	6	6	6	1	1	6	6	6	6	6	6	6	6	6	6	6	1	1	6	6	6	6	6	6	6	6	6	6	6	6	6	6	6	6	6	6	1	1	6	6	6	6	6	6	6	6	6	6	6	6	6	6	6	6	6	6	6
6	6	6	6	6	6	1	1	6	6	6	6	6	6	6	6	6	6	6	1	1	6	6	6	6	6	6	6	6	6	6	6	6	6	6	6	6	6	6	1	1	6	6	6	6	6	6	6	6	6	6	6	6	6	6	6	6	6	6	6
6	6	6	6	6	6	1	1	6	6	6	6	6	6	6	6	6	6	6	1	1	6	6	6	6	6	6	6	6	6	6	6	6	6	6	6	6	6	6	1	1	6	6	6	6	6	6	6	6	6	6	6	6	6	6	6	6	6	6	6
6	6	6	6	6	6	1	1	6	6	6	6	6	6	6	6	6	6	6	1	1	6	6	6	6	6	6	6	6	6	6	6	6	6	6	6	6	6	6	1	1	6	6	6	6	6	6	6	6	6	6	6	6	6	6	6	6	6	6	6
6	6	6	6	6	6	1	1	6	6	6	6	6	6	6	6	6	6	6	1	1	1	1	1	1	1	1	1	1	1	1	1	1	1	1	1	1	1	1	1	1	1	1	1	1	1	1	1	1	1	6	6	6	6	6	6	6	6	6	6
6	6	6	6	6	6	1	1	6	6	6	6	6	6	6	6	6	6	6	1	1	1	1	1	1	1	1	1	1	1	1	1	1	1	1	1	1	1	1	1	1	1	1	1	1	1	1	1	1	1	6	6	6	6	6	6	6	6	6	6
6	6	6	6	6	6	1	1	6	6	6	6	6	6	6	6	6	6	6	1	1	6	6	6	6	6	6	6	6	1	1	6	6	6	6	6	6	6	6	6	6	6	6	6	6	6	6	6	1	1	6	6	6	6	6	6	6	6	6	6
6	6	6	6	6	6	1	1	6	6	6	6	6	6	6	6	6	6	6	1	1	6	6	6	6	6	6	6	6	1	1	6	6	6	6	6	6	6	6	6	6	6	6	6	6	6	6	6	1	1	6	6	6	6	6	6	6	6	6	6
6	6	6	6	6	6	1	1	6	6	6	6	6	6	6	6	6	6	6	1	1	6	6	6	6	6	6	6	6	1	1	6	6	6	6	6	6	6	6	6	6	6	6	6	6	6	6	6	1	1	6	6	6	6	6	6	6	6	6	6
6	6	6	6	6	6	1	1	6	6	6	6	6	6	6	6	6	6	6	1	1	6	6	6	6	6	6	6	6	1	1	6	6	6	6	6	6	6	6	6	6	6	6	6	6	6	6	6	1	1	6	6	6	6	6	6	6	6	6	6
6	6	6	6	6	6	1	1	6	6	6	6	6	6	6	6	6	6	6	1	1	6	6	6	6	6	2	2	6	2	2	6	2	2	6	6	6	6	6	6	6	6	6	6	6	6	6	6	1	1	6	6	6	6	6	6	6	6	6	6
6	6	6	6	6	6	1	1	6	6	6	6	6	6	6	6	6	6	6	1	1	6	6	6	6	6	2	3	3	3	3	3	3	2	6	6	6	6	6	6	6	6	6	6	6	6	6	6	1	1	6	6	6	6	6	6	6	6	6	6
6	6	6	6	6	6	1	1	6	6	6	6	6	6	6	6	6	6	6	1	1	6	6	6	6	6	6	3	4	4	4	4	3	6	6	6	6	6	6	6	6	6	6	6	6	6	6	6	1	1	6	6	6	6	6	6	6	6	6	6
1	1	1	1	1	1	1	1	1	1	1	1	1	1	1	1	1	1	1	1	1	1	1	1	1	1	2	3	4	4	4	4	3	2	1	1	1	1	1	1	1	1	1	1	1	1	1	1	1	1	1	1	1	1	1	1	1	1	1	1
1	1	1	1	1	1	1	1	1	1	1	1	1	1	1	1	1	1	1	1	1	1	1	1	1	1	2	3	4	4	4	4	3	2	1	1	1	1	1	1	1	1	1	1	1	1	1	1	1	1	1	1	1	1	1	1	1	1	1	1
6	6	6	6	6	6	6	6	6	6	1	1	6	6	6	6	6	6	6	6	6	6	6	6	6	6	6	3	4	4	4	4	3	6	6	6	6	6	6	1	1	6	6	6	6	6	6	6	6	6	6	6	1	1	6	6	6	6	6	6
6	6	6	6	6	6	6	6	6	6	1	1	6	6	6	6	6	6	6	6	6	6	6	6	6	6	2	3	3	3	3	3	3	2	6	6	6	6	6	1	1	6	6	6	6	6	6	6	6	6	6	6	1	1	6	6	6	6	6	6
6	6	6	6	6	6	6	6	6	6	1	1	6	6	6	6	6	6	6	6	6	6	6	6	6	6	2	2	6	2	2	6	2	2	6	6	6	6	6	1	1	6	6	6	6	6	6	6	6	6	6	6	1	1	6	6	6	6	6	6
6	6	6	6	6	6	6	6	6	6	1	1	6	6	6	6	6	6	6	6	6	6	6	6	6	6	6	6	6	1	1	6	6	6	6	6	6	6	6	1	1	6	6	6	6	6	6	6	6	6	6	6	1	1	6	6	6	6	6	6
6	6	6	6	6	6	6	6	6	6	1	1	6	6	6	6	6	6	6	6	6	6	6	6	6	6	6	6	6	1	1	6	6	6	6	6	6	6	6	1	1	6	6	6	6	6	6	6	6	6	6	6	1	1	6	6	6	6	6	6
6	6	6	6	6	6	6	6	6	6	1	1	6	6	6	6	6	6	6	6	6	6	6	6	6	6	6	6	6	1	1	6	6	6	6	6	6	6	6	1	1	6	6	6	6	6	6	6	6	6	6	6	1	1	6	6	6	6	6	6
6	6	6	6	6	6	6	6	6	6	1	1	6	6	6	6	6	6	6	6	6	6	6	6	6	6	6	6	6	1	1	6	6	6	6	6	6	6	6	1	1	6	6	6	6	6	6	6	6	6	6	6	1	1	6	6	6	6	6	6
6	6	6	6	6	6	6	6	6	6	1	1	1	1	1	1	1	1	1	1	1	1	1	1	1	1	1	1	1	1	1	1	1	1	1	1	1	1	1	1	1	6	6	6	6	6	6	6	6	6	6	6	1	1	6	6	6	6	6	6
6	6	6	6	6	6	6	6	6	6	1	1	1	1	1	1	1	1	1	1	1	1	1	1	1	1	1	1	1	1	1	1	1	1	1	1	1	1	1	1	1	6	6	6	6	6	6	6	6	6	6	6	1	1	6	6	6	6	6	6
6	6	6	6	6	6	6	6	6	6	6	6	6	6	6	6	6	6	6	1	1	6	6	6	6	6	6	6	6	6	6	6	6	6	6	6	6	6	6	1	1	6	6	6	6	6	6	6	6	6	6	6	1	1	6	6	6	6	6	6
6	6	6	6	6	6	6	6	6	6	6	6	6	6	6	6	6	6	6	1	1	6	6	6	6	6	6	6	6	6	6	6	6	6	6	6	6	6	6	1	1	6	6	6	6	6	6	6	6	6	6	6	1	1	6	6	6	6	6	6
6	6	6	6	6	6	6	6	6	6	6	6	6	6	6	6	6	6	6	1	1	6	6	6	6	6	6	6	6	6	6	6	6	6	6	6	6	6	6	1	1	6	6	6	6	6	6	6	6	6	6	6	1	1	6	6	6	6	6	6
6	6	6	6	6	6	6	6	6	6	6	6	6	6	6	6	6	6	6	1	1	6	6	6	6	6	6	6	6	6	6	6	6	6	6	6	6	6	6	1	1	6	6	6	6	6	6	6	6	6	6	6	1	1	6	6	6	6	6	6
1	1	1	1	1	1	1	1	1	1	1	1	1	1	1	1	1	1	1	1	1	6	6	6	6	6	6	6	6	6	6	6	6	6	6	6	6	6	6	1	1	6	6	6	6	6	6	6	6	6	6	6	1	1	6	6	6	6	6	6
1	1	1	1	1	1	1	1	1	1	1	1	1	1	1	1	1	1	1	1	1	6	6	6	6	6	6	6	6	6	6	6	6	6	6	6	6	6	6	1	1	6	6	6	6	6	6	6	6	6	6	6	1	1	6	6	6	6	6	6
6	6	6	6	6	6	6	6	6	6	6	6	6	6	6	6	6	6	6	6	6	6	6	6	6	6	6	6	6	6	6	6	6	6	6	6	6	6	6	1	1	1	1	1	1	1	1	1	1	1	1	1	1	1	6	6	6	6	6	6
6	6	6	6	6	6	6	6	6	6	6	6	6	6	6	6	6	6	6	6	6	6	6	6	6	6	6	6	6	6	6	6	6	6	6	6	6	6	6	1	1	1	1	1	1	1	1	1	1	1	1	1	1	1	6	6	6	6	6	6
6	6	6	6	6	6	6	6	6	6	6	6	6	6	6	6	6	6	6	6	6	6	6	6	6	6	6	6	6	6	6	6	6	6	6	6	6	6	6	6	6	6	6	6	6	6	6	6	6	6	6	6	6	6	6	6	6	6	6	6
6	6	6	6	6	6	6	6	6	6	6	6	6	6	6	6	6	6	6	6	6	6	6	6	6	6	6	6	6	6	6	6	6	6	6	6	6	6	6	6	6	6	6	6	6	6	6	6	6	6	6	6	6	6	6	6	6	6	6	6
28	15	6
6
1	20	2
1	20	2
1	35	2
59	5	4
59	20	4
59	20	4
