5	5	5	5	5	5	5	5	5	5	5	1	1	5	5	5	5	5	5	5	5	5	5	5	5	5	5	5	5	5	5	1	1	5	5	5	5	5	5	5	5	5	5	5	5	5	5	5	5	5	5	5	5	5	5	5	5	5	5	5
5	5	5	5	5	5	5	5	5	5	5	1	1	5	5	5	5	5	5	5	5	5	5	5	5	5	5	5	5	5	5	1	1	5	5	5	5	5	5	5	5	5	5	5	5	5	5	5	5	5	5	5	5	5	5	5	5	5	5	5
5	5	5	5	5	5	5	5	5	5	5	1	1	5	5	5	5	5	5	5	5	5	5	5	5	5	5	5	5	5	5	1	1	5	5	5	5	5	5	5	5	5	5	5	5	5	5	5	5	5	5	5	5	5	5	5	5	5	5	5
5	5	5	5	5	5	5	5	5	5	5	1	1	5	5	5	5	5	5	5	5	5	5	5	5	5	5	5	5	5	5	1	1	5	5	5	5	5	5	5	5	5	5	5	5	5	5	5	5	2	2	5	2	2	5	2	2	5	5	5
5	5	5	5	5	5	5	5	5	5	5	1	1	5	5	5	5	5	5	5	5	5	5	5	5	5	5	5	5	5	5	1	1	5	5	5	5	5	5	5	5	5	5	5	5	5	5	5	5	2	3	3	3	3	3	3	2	5	5	5
5	5	5	5	5	5	5	5	5	5	5	1	1	5	5	5	5	5	5	5	5	5	5	5	5	5	5	5	5	5	5	1	1	5	5	5	5	5	5	5	5	5	5	5	5	5	5	5	5	5	3	4	4	4	4	3	5	5	5	5
1	1	1	1	1	1	1	1	1	1	1	1	1	1	1	1	1	1	1	1	1	1	1	1	1	1	1	1	1	1	1	1	1	1	1	1	1	1	1	1	1	1	1	1	1	1	1	1	1	2	3	4	4	4	4	3	2	5	5	5
1	1	1	1	1	1	1	1	1	1	1	1	1	1	1	1	1	1	1	1	1	1	1	1	1	1	1	1	1	1	1	1	1	1	1	1	1	1	1	1	1	1	1	1	1	1	1	1	1	2	3	4	4	4	4	3	2	5	5	5
5	5	5	5	5	1	1	5	5	5	5	5	5	5	5	5	5	5	5	5	5	1	1	5	5	5	5	5	5	5	5	5	5	5	5	5	5	5	5	5	5	5	5	5	5	5	5	5	5	5	3	4	4	4	4	3	5	5	5	5
5	5	5	5	5	1	1	5	5	5	5	5	5	5	5	5	5	5	5	5	5	1	1	5	5	5	5	5	5	5	5	5	5	5	5	5	5	5	5	5	5	5	5	5	5	5	5	5	5	2	3	3	3	3	3	3	2	5	5	5
5	5	5	5	5	1	1	5	5	5	5	5	5	5	5	5	5	5	5	5	5	1	1	5	5	5	5	5	5	5	5	5	5	5	5	5	5	5	5	5	5	5	5	5	5	5	5	5	5	2	2	5	2	2	5	2	2	5	5	5
5	5	5	5	5	1	1	5	5	5	5	5	5	5	5	5	5	5	5	5	5	1	1	5	5	5	5	5	5	5	5	5	5	5	5	5	5	5	5	5	5	5	5	5	5	5	5	5	5	5	5	5	1	1	5	5	5	5	5	5
5	5	5	5	5	1	1	5	5	5	5	5	5	5	5	5	5	5	5	5	5	1	1	1	1	1	1	1	1	1	1	1	1	5	5	5	5	5	5	5	5	5	5	5	5	5	5	5	5	5	5	5	1	1	5	5	5	5	5	5
5	5	5	5	5	1	1	5	5	5	5	5	5	5	5	5	5	5	5	5	5	1	1	1	1	1	1	1	1	1	1	1	1	5	5	5	5	5	5	5	5	5	5	5	5	5	5	5	5	5	5	5	1	1	5	5	5	5	5	5
5	5	5	5	5	1	1	1	1	1	1	1	1	1	1	5	5	5	5	5	5	1	1	5	5	5	5	5	5	5	5	1	1	5	5	5	5	5	5	5	5	1	1	1	1	1	1	1	1	1	1	1	1	1	5	5	5	5	5	5
5	5	5	5	5	1	1	1	1	1	1	1	1	1	1	5	5	5	5	5	5	1	1	5	5	5	5	5	5	5	5	1	1	5	5	5	5	5	5	5	5	1	1	1	1	1	1	1	1	1	1	1	1	1	5	5	5	5	5	5
5	5	5	5	5	1	1	5	5	5	5	5	5	1	1	5	5	5	5	5	5	1	1	5	5	5	5	5	5	5	5	1	1	5	5	5	5	5	5	5	5	1	1	5	5	5	5	5	5	5	5	5	1	1	5	5	5	5	5	5
5	5	5	5	5	1	1	5	5	5	5	5	5	1	1	5	5	5	5	5	5	1	1	5	5	5	5	5	5	5	5	1	1	5	5	5	5	5	5	5	5	1	1	5	5	5	5	5	5	5	5	5	1	1	5	5	5	5	5	5
5	5	5	5	5	1	1	5	5	5	5	5	5	1	1	5	5	5	5	5	5	1	1	5	5	5	5	5	5	5	5	1	1	5	5	5	5	5	5	5	5	1	1	5	5	5	5	5	5	5	5	5	1	1	5	5	5	5	5	5
5	5	5	5	5	1	1	5	5	5	5	5	5	1	1	1	1	1	1	1	1	1	1	1	1	1	1	1	1	1	1	1	1	1	1	1	1	1	1	1	1	1	1	5	5	5	5	5	5	5	5	5	1	1	5	5	5	5	5	5
5	5	5	5	5	1	1	5	5	5	5	5	5	1	1	1	1	1	1	1	1	1	1	1	1	1	1	1	1	1	1	1	1	1	1	1	1	1	1	1	1	1	1	5	5	5	5	5	5	5	5	5	1	1	5	5	5	5	5	5
5	5	5	5	5	1	1	5	5	5	5	5	5	5	5	5	5	5	5	5	5	1	1	5	5	5	5	5	5	5	5	5	5	5	5	5	5	5	5	5	5	1	1	5	5	5	5	5	5	5	5	5	1	1	5	5	5	5	5	5
5	5	5	5	5	1	1	5	5	5	5	5	5	5	5	5	5	5	5	5	5	1	1	5	5	5	5	5	5	5	5	5	5	5	5	5	5	5	5	5	5	1	1	5	5	5	5	5	5	5	5	5	1	1	5	5	5	5	5	5
5	5	5	5	5	1	1	5	5	5	5	5	5	5	5	5	5	5	5	5	5	1	1	5	5	5	5	5	5	5	5	5	5	5	5	5	5	5	5	5	5	1	1	5	5	5	5	5	5	5	5	5	1	1	5	5	5	5	5	5
5	5	5	5	5	1	1	5	5	5	5	5	5	5	5	5	5	5	5	5	5	1	1	5	5	5	5	5	5	5	5	5	5	5	5	5	5	5	5	5	5	1	1	5	5	5	5	5	5	5	5	5	1	1	1	1	1	1	1	1
5	5	5	5	5	1	1	5	5	5	5	5	5	5	5	5	5	5	5	5	5	1	1	5	5	5	5	5	5	5	5	5	5	5	5	5	5	5	5	5	5	1	1	5	5	5	5	5	5	5	5	5	1	1	1	1	1	1	1	1
5	5	5	5	5	1	1	5	5	5	5	5	5	5	5	5	5	5	5	5	5	1	1	5	5	5	5	5	5	5	5	5	5	5	5	5	5	5	5	5	5	1	1	5	5	5	5	5	5	5	5	5	1	1	5	5	5	5	5	5
1	1	1	1	1	1	1	1	1	1	1	1	1	1	1	1	1	1	1	1	1	1	1	5	5	5	5	5	5	5	5	5	1	1	1	1	1	1	1	1	1	1	1	5	5	5	5	5	5	5	5	5	1	1	5	5	5	5	5	5
1	1	1	1	1	1	1	1	1	1	1	1	1	1	1	1	1	1	1	1	1	1	1	5	5	5	5	5	5	5	5	5	1	1	1	1	1	1	1	1	1	1	1	5	5	5	5	5	5	5	5	5	1	1	5	5	5	5	5	5
5	5	5	5	5	1	1	5	5	5	5	5	5	5	5	5	5	5	5	5	5	1	1	5	5	5	5	5	5	5	5	5	1	1	5	5	5	5	5	5	5	1	1	5	5	5	5	5	5	5	5	5	1	1	5	5	5	5	5	5
5	5	5	5	5	1	1	5	5	5	5	5	5	5	5	5	5	5	5	5	5	1	1	5	5	5	5	5	5	5	5	5	1	1	5	5	5	5	5	5	5	1	1	5	5	5	5	5	5	5	5	5	1	1	5	5	5	5	5	5
5	5	5	5	5	1	1	5	5	5	5	5	5	5	5	5	5	5	5	5	5	1	1	1	1	1	1	1	1	1	1	1	1	1	5	5	5	5	5	5	5	1	1	5	5	5	5	5	5	5	5	5	1	1	5	5	5	5	5	5
5	5	5	5	5	1	1	5	5	5	5	5	5	5	5	5	5	5	5	5	5	1	1	1	1	1	1	1	1	1	1	1	1	1	5	5	5	5	5	5	5	1	1	1	1	1	1	1	1	1	1	1	1	1	5	5	5	5	5	5
5	5	5	5	5	1	1	5	5	5	5	5	5	5	5	5	5	5	5	5	5	1	1	5	5	5	5	5	5	5	5	5	1	1	5	5	5	5	5	5	5	1	1	1	1	1	1	1	1	1	1	1	1	1	5	5	5	5	5	5
5	5	5	5	5	1	1	5	5	5	5	5	5	5	5	5	5	5	5	5	5	1	1	5	5	5	5	5	5	5	5	5	1	1	5	5	5	5	5	5	5	5	5	5	5	5	5	5	5	5	5	5	1	1	5	5	5	5	5	5
5	5	5	5	5	1	1	1	1	1	1	1	1	1	1	1	1	1	1	1	1	1	1	5	5	5	5	5	5	5	5	5	1	1	5	5	5	5	5	5	5	5	5	5	5	5	5	5	5	5	5	5	1	1	5	5	5	5	5	5
5	5	5	5	5	1	1	1	1	1	1	1	1	1	1	1	1	1	1	1	1	1	1	5	5	5	5	5	5	5	5	5	1	1	5	5	5	5	5	5	5	5	5	5	5	5	5	5	5	5	5	5	1	1	5	5	5	5	5	5
5	5	5	5	5	5	5	5	5	5	5	5	5	5	5	5	5	5	5	5	5	1	1	5	5	5	5	5	5	5	5	5	1	1	5	5	5	5	5	5	5	5	5	5	5	5	5	5	5	5	5	5	1	1	5	5	5	5	5	5
5	5	5	5	5	5	5	5	5	5	5	5	5	5	5	5	5	5	5	5	5	1	1	5	5	5	5	5	5	5	5	5	1	1	5	5	5	5	5	5	5	5	5	5	5	5	5	5	5	5	5	5	1	1	5	5	5	5	5	5
5	5	5	5	5	5	5	5	5	5	5	5	5	5	5	5	5	5	5	5	5	1	1	5	5	5	5	5	5	5	5	5	1	1	5	5	5	5	5	5	5	5	5	5	5	5	5	5	5	5	5	5	1	1	5	5	5	5	5	5
51	2	6
8
12	1	3
32	1	3
1	7	2
1	28	2
22	39	1
33	39	1
53	39	1
59	25	4
